Feature ID	Taxon
Vitrella	Vitrella
Naegleria	Naegleria
Trichomonas	Trichomonas
Spironucleus	Spironucleus
Giardia	Giardia
Entamoeba	Entamoeba
Chromera	Chromera
Monocercomonoides	Monocercomonoides
Bodo	Bodo
Paratrypanosoma	Paratrypanosoma
Blechomonas	Blechomonas
Leptomonas	Leptomonas
Leishmania	Leishmania
Trypanosoma	Trypanosoma
Acanthamoeba	Acanthamoeba
Albugo	Albugo
Phytopythium	Phytopythium
Globisporangium	Globisporangium
Pythium	Pythium
Hyaloperonospora	Hyaloperonospora
Phytophthora	Phytophthora
Saprolegnia	Saprolegnia
Aphanomyces	Aphanomyces
Gregarina	Gregarina
Cryptosporidium	Cryptosporidium
Eimeria	Eimeria
Cyclospora	Cyclospora
Cystoisospora	Cystoisospora
Neospora	Neospora
Sarcocystis	Sarcocystis
Toxoplasma	Toxoplasma
Hammondia	Hammondia
Babesia	Babesia
Cytauxzoon	Cytauxzoon
Theileria	Theileria
Plasmodium	Plasmodium
Spizellomyces	Spizellomyces
Batrachochytrium	Batrachochytrium
Rhizophagus	Rhizophagus
Phycomyces	Phycomyces
Rhizopus	Rhizopus
Mucor	Mucor
Allomyces	Allomyces
Ordospora	Ordospora
Vavraia	Vavraia
Trachipleistophora	Trachipleistophora
Mitosporidium	Mitosporidium
Spraguea	Spraguea
Hamiltosporidium	Hamiltosporidium
Amphiamblys	Amphiamblys
Encephalitozoon	Encephalitozoon
Nematocida	Nematocida
Pseudoloma	Pseudoloma
Nosema	Nosema
Vittaforma	Vittaforma
Edhazardia	Edhazardia
Anncaliia	Anncaliia
Enterospora	Enterospora
Hepatospora	Hepatospora
Enterocytozoon	Enterocytozoon
Pneumocystis	Pneumocystis
Schizosaccharomyces	Schizosaccharomyces
Sclerotinia	Sclerotinia
Yarrowia	Yarrowia
Clavispora	Clavispora
Candida	Candida
Nakaseomyces	Nakaseomyces
Saccharomyces	Saccharomyces
Zymoseptoria	Zymoseptoria
Cenococcum	Cenococcum
Sporothrix	Sporothrix
Pyricularia	Pyricularia
Neurospora	Neurospora
Sordaria	Sordaria
Fusarium	Fusarium
Trichoderma	Trichoderma
Lomentospora	Lomentospora
Scedosporium	Scedosporium
Cyphellophora	Cyphellophora
Fonsecaea	Fonsecaea
Cladophialophora	Cladophialophora
Exophiala	Exophiala
Talaromyces	Talaromyces
Penicilliopsis	Penicilliopsis
Penicillium	Penicillium
Aspergillus	Aspergillus
Histoplasma	Histoplasma
Coccidioides	Coccidioides
Paracoccidioides	Paracoccidioides
Chrysosporium	Chrysosporium
Uncinocarpus	Uncinocarpus
Byssoonygena	Byssoonygena
Amauroascus	Amauroascus
Melampsora	Melampsora
Coprinopsis	Coprinopsis
Phanerochaete	Phanerochaete
Tremella	Tremella
Kwoniella	Kwoniella
Cryptococcus	Cryptococcus
Naganishia	Naganishia
Ustilago	Ustilago
Sporisorium	Sporisorium
Malassezia	Malassezia
Caldisericum	Caldisericum
Candidatus_Chazhemtobacterium	Candidatus_Chazhemtobacterium
Coprothermobacter	Coprothermobacter
Caldithrix	Caldithrix
Caldimicrobium	Caldimicrobium
Thermosulfuriphilus	Thermosulfuriphilus
Thermodesulfatator	Thermodesulfatator
Thermosulfurimonas	Thermosulfurimonas
Thermodesulfobacterium	Thermodesulfobacterium
Candidatus_Bipolaricaulis	Candidatus_Bipolaricaulis
Thermobaculum	Thermobaculum
Candidatus_Cloacimonas	Candidatus_Cloacimonas
Elusimicrobium	Elusimicrobium
Endomicrobium	Endomicrobium
Desulfurispirillum	Desulfurispirillum
Geovibrio	Geovibrio
Flexistipes	Flexistipes
Denitrovibrio	Denitrovibrio
Deferribacter	Deferribacter
Calditerrivibrio	Calditerrivibrio
Fimbriimonas	Fimbriimonas
Chthonomonas	Chthonomonas
Candidatus_Cyclonatronum	Candidatus_Cyclonatronum
Dictyoglomus	Dictyoglomus
Thermovibrio	Thermovibrio
Desulfurobacterium	Desulfurobacterium
Thermosulfidibacter	Thermosulfidibacter
Persephonella	Persephonella
Sulfurihydrogenibium	Sulfurihydrogenibium
Aquifex	Aquifex
Thermocrinis	Thermocrinis
Hydrogenobacter	Hydrogenobacter
Hydrogenobaculum	Hydrogenobaculum
Athalassotoga	Athalassotoga
Pseudothermotoga	Pseudothermotoga
Thermotoga	Thermotoga
Fervidobacterium	Fervidobacterium
Thermosipho	Thermosipho
Kosmotoga	Kosmotoga
Mesotoga	Mesotoga
Petrotoga	Petrotoga
Marinitoga	Marinitoga
Defluviitoga	Defluviitoga
Candidatus_Babela	Candidatus_Babela
Kiritimatiella	Kiritimatiella
Chloroherpeton	Chloroherpeton
Prosthecochloris	Prosthecochloris
Pelodictyon	Pelodictyon
Chlorobaculum	Chlorobaculum
Chlorobium	Chlorobium
Fibrobacter	Fibrobacter
Acetomicrobium	Acetomicrobium
Thermovirga	Thermovirga
Aminobacterium	Aminobacterium
Aminomonas	Aminomonas
Jonquetella	Jonquetella
Cloacibacillus	Cloacibacillus
Thermanaerovibrio	Thermanaerovibrio
Chlamydia	Chlamydia
Waddlia	Waddlia
Simkania	Simkania
Parachlamydia	Parachlamydia
Neochlamydia	Neochlamydia
Candidatus_Protochlamydia	Candidatus_Protochlamydia
Ignavibacterium	Ignavibacterium
Melioribacter	Melioribacter
Leptospirillum	Leptospirillum
Thermodesulfovibrio	Thermodesulfovibrio
Nitrospira	Nitrospira
Brachyspira	Brachyspira
Turneriella	Turneriella
Leptospira	Leptospira
Borreliella	Borreliella
Borrelia	Borrelia
Sediminispirochaeta	Sediminispirochaeta
Oceanispirochaeta	Oceanispirochaeta
Salinispira	Salinispira
Sphaerochaeta	Sphaerochaeta
Spirochaeta	Spirochaeta
Treponema	Treponema
Vampirococcus	Vampirococcus
Ktedonosporobacter	Ktedonosporobacter
Sphaerobacter	Sphaerobacter
Thermomicrobium	Thermomicrobium
Dehalogenimonas	Dehalogenimonas
Dehalococcoides	Dehalococcoides
Candidatus_Promineofilum	Candidatus_Promineofilum
Chloroflexus	Chloroflexus
Roseiflexus	Roseiflexus
Tepidiforma	Tepidiforma
Caldilinea	Caldilinea
Pelolinea	Pelolinea
Brevefilum	Brevefilum
Anaerolinea	Anaerolinea
Gloeomargarita	Gloeomargarita
Pleurocapsa	Pleurocapsa
Stanieria	Stanieria
Chroococcidiopsis	Chroococcidiopsis
Gloeobacter	Gloeobacter
Geitlerinema	Geitlerinema
Limnospira	Limnospira
Planktothrix	Planktothrix
Microcoleus	Microcoleus
Oxynema	Oxynema
Trichodesmium	Trichodesmium
Arthrospira	Arthrospira
Crinalium	Crinalium
Moorea	Moorea
Oscillatoria	Oscillatoria
Cyanothece	Cyanothece
Microcystis	Microcystis
Gloeocapsa	Gloeocapsa
Chondrocystis	Chondrocystis
Geminocystis	Geminocystis
Rippkaea	Rippkaea
Euhalothece	Euhalothece
Halothece	Halothece
Crocosphaera	Crocosphaera
Candidatus_Atelocyanobacterium	Candidatus_Atelocyanobacterium
Gloeothece	Gloeothece
Cyanobacterium	Cyanobacterium
Halomicronema	Halomicronema
Chamaesiphon	Chamaesiphon
Leptolyngbya	Leptolyngbya
Pseudanabaena	Pseudanabaena
Acaryochloris	Acaryochloris
Prochlorococcus	Prochlorococcus
Thermoleptolyngbya	Thermoleptolyngbya
Synechocystis	Synechocystis
Thermosynechococcus	Thermosynechococcus
Cyanobium	Cyanobium
Dactylococcopsis	Dactylococcopsis
Synechococcus	Synechococcus
Tolypothrix	Tolypothrix
Microchaete	Microchaete
Rivularia	Rivularia
Raphidiopsis	Raphidiopsis
Nodularia	Nodularia
Sphaerospermopsis	Sphaerospermopsis
Dolichospermum	Dolichospermum
Anabaenopsis	Anabaenopsis
Fischerella	Fischerella
Brasilonema	Brasilonema
Scytonema	Scytonema
Calothrix	Calothrix
Trichormus	Trichormus
Cylindrospermum	Cylindrospermum
Anabaena	Anabaena
Nostoc	Nostoc
Chloracidobacterium	Chloracidobacterium
Luteitalea	Luteitalea
Candidatus_Solibacter	Candidatus_Solibacter
Acidisarcina	Acidisarcina
Acidobacterium	Acidobacterium
Edaphobacter	Edaphobacter
Candidatus_Koribacter	Candidatus_Koribacter
Granulicella	Granulicella
Terriglobus	Terriglobus
Gemmatirosa	Gemmatirosa
Gemmatimonas	Gemmatimonas
Candidatus_Izimaplasma	Candidatus_Izimaplasma
Entomoplasma	Entomoplasma
Mesoplasma	Mesoplasma
Spiroplasma	Spiroplasma
Candidatus_Phytoplasma	Candidatus_Phytoplasma
Acholeplasma	Acholeplasma
Candidatus_Hepatoplasma	Candidatus_Hepatoplasma
Ureaplasma	Ureaplasma
Mycoplasma	Mycoplasma
Candidatus_Saccharimonas	Candidatus_Saccharimonas
Candidatus_Kuenenia	Candidatus_Kuenenia
Limihaloglobus	Limihaloglobus
Sedimentisphaera	Sedimentisphaera
Anaerohalosphaera	Anaerohalosphaera
Phycisphaera	Phycisphaera
Gimesia	Gimesia
Fuerstia	Fuerstia
Rubinisphaera	Rubinisphaera
Planctopirus	Planctopirus
Bremerella	Bremerella
Crateriforma	Crateriforma
Alienimonas	Alienimonas
Planctomyces	Planctomyces
Isosphaera	Isosphaera
Singulisphaera	Singulisphaera
Paludisphaera	Paludisphaera
Aquisphaera	Aquisphaera
Thermogutta	Thermogutta
Roseimaritima	Roseimaritima
Rhodopirellula	Rhodopirellula
Pirellula	Pirellula
Mariniblastus	Mariniblastus
Bythopirellula	Bythopirellula
Lacipirellula	Lacipirellula
Tuwongella	Tuwongella
Gemmata	Gemmata
Limnoglobus	Limnoglobus
Candidatus_Xiphinematobacter	Candidatus_Xiphinematobacter
Methylacidiphilum	Methylacidiphilum
Luteolibacter	Luteolibacter
Roseimicrobium	Roseimicrobium
Verrucomicrobium	Verrucomicrobium
Akkermansia	Akkermansia
Coraliomargarita	Coraliomargarita
Ereboglobus	Ereboglobus
Opitutus	Opitutus
Nibricoccus	Nibricoccus
Lacunisphaera	Lacunisphaera
Sneathia	Sneathia
Sebaldella	Sebaldella
Pseudoleptotrichia	Pseudoleptotrichia
Streptobacillus	Streptobacillus
Leptotrichia	Leptotrichia
Ilyobacter	Ilyobacter
Fusobacterium	Fusobacterium
Saprospira	Saprospira
Haliscomenobacter	Haliscomenobacter
Salinibacter	Salinibacter
Rhodothermus	Rhodothermus
Niabella	Niabella
Paraflavitalea	Paraflavitalea
Pseudobacter	Pseudobacter
Flavihumibacter	Flavihumibacter
Lacibacter	Lacibacter
Arachidicoccus	Arachidicoccus
Panacibacter	Panacibacter
Filimonas	Filimonas
Flavisolibacter	Flavisolibacter
Chitinophaga	Chitinophaga
Niastella	Niastella
Olivibacter	Olivibacter
Anseongella	Anseongella
Solitalea	Solitalea
Pedobacter	Pedobacter
Sphingobacterium	Sphingobacterium
Pseudopedobacter	Pseudopedobacter
Mucilaginibacter	Mucilaginibacter
Roseivirga	Roseivirga
Candidatus_Cardinium	Candidatus_Cardinium
Candidatus_Amoebophilus	Candidatus_Amoebophilus
Bernardetia	Bernardetia
Flammeovirga	Flammeovirga
Chryseolinea	Chryseolinea
Marivirga	Marivirga
Allopseudarcicella	Allopseudarcicella
Arcticibacterium	Arcticibacterium
Cytophaga	Cytophaga
Dyadobacter	Dyadobacter
Rhodocytophaga	Rhodocytophaga
Leadbetterella	Leadbetterella
Runella	Runella
Fibrella	Fibrella
Spirosoma	Spirosoma
Belliella	Belliella
Aquiflexum	Aquiflexum
Cyclobacterium	Cyclobacterium
Algoriphagus	Algoriphagus
Echinicola	Echinicola
Nibribacter	Nibribacter
Adhaeribacter	Adhaeribacter
Pontibacter	Pontibacter
Rufibacter	Rufibacter
Hymenobacter	Hymenobacter
Salinivirga	Salinivirga
Alkalitalea	Alkalitalea
Labilibaculum	Labilibaculum
Draconibacterium	Draconibacterium
Tenuifilum	Tenuifilum
Paludibacter	Paludibacter
Barnesiella	Barnesiella
Dysgonomonas	Dysgonomonas
Fermentimonas	Fermentimonas
Proteiniphilum	Proteiniphilum
Petrimonas	Petrimonas
Duncaniella	Duncaniella
Muribaculum	Muribaculum
Mucinivorans	Mucinivorans
Alistipes	Alistipes
Butyricimonas	Butyricimonas
Odoribacter	Odoribacter
Candidatus_Azobacteroides	Candidatus_Azobacteroides
Phocaeicola	Phocaeicola
Porphyromonas	Porphyromonas
Bacteroides	Bacteroides
Tannerella	Tannerella
Parabacteroides	Parabacteroides
Alloprevotella	Alloprevotella
Paraprevotella	Paraprevotella
Prevotella	Prevotella
Ichthyobacterium	Ichthyobacterium
Bergeyella	Bergeyella
Candidatus_Sulcia	Candidatus_Sulcia
Candidatus_Walczuchella	Candidatus_Walczuchella
Ornithobacterium	Ornithobacterium
Apibacter	Apibacter
Owenweeksia	Owenweeksia
Blattabacterium	Blattabacterium
Weeksella	Weeksella
Riemerella	Riemerella
Empedobacter	Empedobacter
Elizabethkingia	Elizabethkingia
Fluviicola	Fluviicola
Chryseobacterium	Chryseobacterium
Gillisia	Gillisia
Euzebyella	Euzebyella
Mesoflavibacter	Mesoflavibacter
Lutibacter	Lutibacter
Zobellia	Zobellia
Gilvibacter	Gilvibacter
Muriicola	Muriicola
Muricauda	Muricauda
Leeuwenhoekiella	Leeuwenhoekiella
Flagellimonas	Flagellimonas
Flavivirga	Flavivirga
Robiginitalea	Robiginitalea
Aureitalea	Aureitalea
Urechidicola	Urechidicola
Psychroflexus	Psychroflexus
Sediminicola	Sediminicola
Costertonia	Costertonia
Cellulophaga	Cellulophaga
Galbibacter	Galbibacter
Myroides	Myroides
Antarcticibacterium	Antarcticibacterium
Arenibacter	Arenibacter
Salegentibacter	Salegentibacter
Psychroserpens	Psychroserpens
Zunongwangia	Zunongwangia
Olleya	Olleya
Siansivirga	Siansivirga
Mariniflexile	Mariniflexile
Formosa	Formosa
Polaribacter	Polaribacter
Croceibacter	Croceibacter
Seonamhaeicola	Seonamhaeicola
Wenyingzhuangia	Wenyingzhuangia
Dokdonia	Dokdonia
Gramella	Gramella
Tamlana	Tamlana
Aequorivita	Aequorivita
Nonlabens	Nonlabens
Aquimarina	Aquimarina
Algibacter	Algibacter
Lacinutrix	Lacinutrix
Changchengzhania	Changchengzhania
Tenacibaculum	Tenacibaculum
Kordia	Kordia
Maribacter	Maribacter
Winogradskyella	Winogradskyella
Oceanihabitans	Oceanihabitans
Capnocytophaga	Capnocytophaga
Flavobacterium	Flavobacterium
Cloacibacterium	Cloacibacterium
Truepera	Truepera
Deinococcus	Deinococcus
Marinithermus	Marinithermus
Oceanithermus	Oceanithermus
Meiothermus	Meiothermus
Thermus	Thermus
Ndongobacter	Ndongobacter
Limnochorda	Limnochorda
Turicibacter	Turicibacter
Erysipelothrix	Erysipelothrix
Intestinibaculum	Intestinibaculum
Faecalibaculum	Faecalibaculum
Amedibacterium	Amedibacterium
Erysipelatoclostridium	Erysipelatoclostridium
Longibaculum	Longibaculum
Faecalitalea	Faecalitalea
Acidaminococcus	Acidaminococcus
Phascolarctobacterium	Phascolarctobacterium
Methylomusa	Methylomusa
Sporomusa	Sporomusa
Pelosinus	Pelosinus
Pectinatus	Pectinatus
Megamonas	Megamonas
Selenomonas	Selenomonas
Megasphaera	Megasphaera
Dialister	Dialister
Veillonella	Veillonella
Natranaerobius	Natranaerobius
Anoxybacter	Anoxybacter
Halothermothrix	Halothermothrix
Halanaerobium	Halanaerobium
Halocella	Halocella
Acetohalobium	Acetohalobium
Halobacteroides	Halobacteroides
Thermodesulfobium	Thermodesulfobium
Mahella	Mahella
Thermanaeromonas	Thermanaeromonas
Thermacetogenium	Thermacetogenium
Ammonifex	Ammonifex
Thermoanaerobacter	Thermoanaerobacter
Tepidanaerobacter	Tepidanaerobacter
Carboxydothermus	Carboxydothermus
Caldanaerobacter	Caldanaerobacter
Moorella	Moorella
Thermosediminibacter	Thermosediminibacter
Caldicellulosiruptor	Caldicellulosiruptor
Thermoanaerobacterium	Thermoanaerobacterium
Candidatus_Syntrophocurvum	Candidatus_Syntrophocurvum
Syntrophothermus	Syntrophothermus
Syntrophomonas	Syntrophomonas
Petrocella	Petrocella
Carboxydocella	Carboxydocella
Symbiobacterium	Symbiobacterium
Heliorestis	Heliorestis
Heliobacterium	Heliobacterium
Thermaerobacter	Thermaerobacter
Desulfofarcimen	Desulfofarcimen
Candidatus_Desulforudis	Candidatus_Desulforudis
Desulfallas	Desulfallas
Thermincola	Thermincola
Dehalobacterium	Dehalobacterium
Desulfitobacterium	Desulfitobacterium
Desulfotomaculum	Desulfotomaculum
Desulfosporosinus	Desulfosporosinus
Dehalobacter	Dehalobacter
Syntrophobotulus	Syntrophobotulus
Christensenella	Christensenella
Acetobacterium	Acetobacterium
Eubacterium	Eubacterium
Oscillibacter	Oscillibacter
Dysosmobacter	Dysosmobacter
Intestinimonas	Intestinimonas
Flintibacter	Flintibacter
Massilistercora	Massilistercora
Ethanoligenens	Ethanoligenens
Caproiciproducens	Caproiciproducens
Flavonifractor	Flavonifractor
Ruthenibacterium	Ruthenibacterium
Ruminococcus	Ruminococcus
Faecalibacterium	Faecalibacterium
Crassaminicella	Crassaminicella
Caloramator	Caloramator
Candidatus_Arthromitus	Candidatus_Arthromitus
Geosporobacter	Geosporobacter
Caloranaerobacter	Caloranaerobacter
Hathewaya	Hathewaya
Alkaliphilus	Alkaliphilus
Hungatella	Hungatella
Clostridium	Clostridium
Aminipila	Aminipila
Mogibacterium	Mogibacterium
Paeniclostridium	Paeniclostridium
Romboutsia	Romboutsia
Acetoanaerobium	Acetoanaerobium
Peptacetobacter	Peptacetobacter
Filifactor	Filifactor
Peptoclostridium	Peptoclostridium
Paraclostridium	Paraclostridium
Clostridioides	Clostridioides
Thermoclostridium	Thermoclostridium
Mageeibacillus	Mageeibacillus
Hungateiclostridium	Hungateiclostridium
Ruminiclostridium	Ruminiclostridium
Pseudoclostridium	Pseudoclostridium
Fastidiosipila	Fastidiosipila
Cellulosilyticum	Cellulosilyticum
Pseudobutyrivibrio	Pseudobutyrivibrio
Herbinix	Herbinix
Anaerotignum	Anaerotignum
Anaerocolumna	Anaerocolumna
Lachnoanaerobaculum	Lachnoanaerobaculum
Butyrivibrio	Butyrivibrio
Lacrimispora	Lacrimispora
Mediterraneibacter	Mediterraneibacter
Enterocloster	Enterocloster
Lachnoclostridium	Lachnoclostridium
Lachnospira	Lachnospira
Anaerobutyricum	Anaerobutyricum
Roseburia	Roseburia
Blautia	Blautia
Anaerostipes	Anaerostipes
Ezakiella	Ezakiella
Gottschalkia	Gottschalkia
Gudongella	Gudongella
Tissierella	Tissierella
Murdochiella	Murdochiella
Peptoniphilus	Peptoniphilus
Anaerococcus	Anaerococcus
Parvimonas	Parvimonas
Finegoldia	Finegoldia
Oenococcus	Oenococcus
Leuconostoc	Leuconostoc
Weissella	Weissella
Jeotgalibaca	Jeotgalibaca
Marinilactibacillus	Marinilactibacillus
Dolosigranulum	Dolosigranulum
Carnobacterium	Carnobacterium
Melissococcus	Melissococcus
Vagococcus	Vagococcus
Tetragenococcus	Tetragenococcus
Enterococcus	Enterococcus
Pediococcus	Pediococcus
Lactobacillus	Lactobacillus
Suicoccus	Suicoccus
Aerococcus	Aerococcus
Abiotrophia	Abiotrophia
Lactococcus	Lactococcus
Streptococcus	Streptococcus
Sporolactobacillus	Sporolactobacillus
Kroppenstedtia	Kroppenstedtia
Novibacillus	Novibacillus
Thermoactinomyces	Thermoactinomyces
Laceyella	Laceyella
Staphylospora	Staphylospora
Listeria	Listeria
Brochothrix	Brochothrix
Kyrpidia	Kyrpidia
Alicyclobacillus	Alicyclobacillus
Tumebacillus	Tumebacillus
Planomicrobium	Planomicrobium
Kurthia	Kurthia
Ureibacillus	Ureibacillus
Paenisporosarcina	Paenisporosarcina
Solibacillus	Solibacillus
Jeotgalibacillus	Jeotgalibacillus
Rummeliibacillus	Rummeliibacillus
Planococcus	Planococcus
Sporosarcina	Sporosarcina
Exiguobacterium	Exiguobacterium
Aneurinibacillus	Aneurinibacillus
Saccharibacillus	Saccharibacillus
Thermobacillus	Thermobacillus
Brevibacillus	Brevibacillus
Cohnella	Cohnella
Paenibacillus	Paenibacillus
Gemella	Gemella
Mesobacillus	Mesobacillus
Pradoshia	Pradoshia
Pontibacillus	Pontibacillus
Psychrobacillus	Psychrobacillus
Fictibacillus	Fictibacillus
Neobacillus	Neobacillus
Halobacillus	Halobacillus
Cytobacillus	Cytobacillus
Gracilibacillus	Gracilibacillus
Metabacillus	Metabacillus
Salicibibacter	Salicibibacter
Lentibacillus	Lentibacillus
Oceanobacillus	Oceanobacillus
Virgibacillus	Virgibacillus
Paraliobacillus	Paraliobacillus
Salimicrobium	Salimicrobium
Terribacillus	Terribacillus
Parageobacillus	Parageobacillus
Lysinibacillus	Lysinibacillus
Peribacillus	Peribacillus
Aeribacillus	Aeribacillus
Amphibacillus	Amphibacillus
Geobacillus	Geobacillus
Alkalihalobacillus	Alkalihalobacillus
Anoxybacillus	Anoxybacillus
Bacillus	Bacillus
Jeotgalicoccus	Jeotgalicoccus
Salinicoccus	Salinicoccus
Auricoccus	Auricoccus
Macrococcus	Macrococcus
Staphylococcus	Staphylococcus
Conexibacter	Conexibacter
Acidimicrobium	Acidimicrobium
Ilumatobacter	Ilumatobacter
Egicoccus	Egicoccus
Egibacter	Egibacter
Euzebya	Euzebya
Baekduia	Baekduia
Rubrobacter	Rubrobacter
Cryptobacterium	Cryptobacterium
Phoenicibacter	Phoenicibacter
Arabia	Arabia
Slackia	Slackia
Denitrobacterium	Denitrobacterium
Gordonibacter	Gordonibacter
Eggerthella	Eggerthella
Adlercreutzia	Adlercreutzia
Coriobacterium	Coriobacterium
Collinsella	Collinsella
Libanicoccus	Libanicoccus
Parolsenella	Parolsenella
Olsenella	Olsenella
Atopobium	Atopobium
Thermobispora	Thermobispora
Nakamurella	Nakamurella
Candidatus_Nanopelagicus	Candidatus_Nanopelagicus
Candidatus_Planktophila	Candidatus_Planktophila
Acidothermus	Acidothermus
Actinopolyspora	Actinopolyspora
Jiangella	Jiangella
Catenulispora	Catenulispora
Modestobacter	Modestobacter
Geodermatophilus	Geodermatophilus
Blastococcus	Blastococcus
Stackebrandtia	Stackebrandtia
Kineococcus	Kineococcus
Epidermidibacterium	Epidermidibacterium
Scardovia	Scardovia
Parascardovia	Parascardovia
Gardnerella	Gardnerella
Bifidobacterium	Bifidobacterium
Actinobaculum	Actinobaculum
Arcanobacterium	Arcanobacterium
Pauljensenia	Pauljensenia
Flaviflexus	Flaviflexus
Actinotignum	Actinotignum
Trueperella	Trueperella
Schaalia	Schaalia
Actinomyces	Actinomyces
Mobiluncus	Mobiluncus
Thermobifida	Thermobifida
Nocardiopsis	Nocardiopsis
Streptomonospora	Streptomonospora
Nonomuraea	Nonomuraea
Streptosporangium	Streptosporangium
Thermomonospora	Thermomonospora
Actinomadura	Actinomadura
Jatrophihabitans	Jatrophihabitans
Frankia	Frankia
Phytohabitans	Phytohabitans
Actinoplanes	Actinoplanes
Salinispora	Salinispora
Micromonospora	Micromonospora
Plantactinospora	Plantactinospora
Verrucosispora	Verrucosispora
Kitasatospora	Kitasatospora
Streptacidiphilus	Streptacidiphilus
Streptomyces	Streptomyces
Alloactinosynnema	Alloactinosynnema
Kibdelosporangium	Kibdelosporangium
Allokutzneria	Allokutzneria
Lentzea	Lentzea
Kutzneria	Kutzneria
Saccharomonospora	Saccharomonospora
Saccharopolyspora	Saccharopolyspora
Actinosynnema	Actinosynnema
Actinoalloteichus	Actinoalloteichus
Saccharothrix	Saccharothrix
Amycolatopsis	Amycolatopsis
Prauserella	Prauserella
Pseudonocardia	Pseudonocardia
Jonesia	Jonesia
Tropheryma	Tropheryma
Haloactinobacterium	Haloactinobacterium
Ruania	Ruania
Austwickia	Austwickia
Mobilicoccus	Mobilicoccus
Dermatophilus	Dermatophilus
Miniimonas	Miniimonas
Beutenbergia	Beutenbergia
Luteimicrobium	Luteimicrobium
Georgenia	Georgenia
Sanguibacter	Sanguibacter
Paraoerskovia	Paraoerskovia
Oerskovia	Oerskovia
Actinotalea	Actinotalea
Pseudactinotalea	Pseudactinotalea
Cellulomonas	Cellulomonas
Devriesea	Devriesea
Dermabacter	Dermabacter
Brachybacterium	Brachybacterium
Cellulosimicrobium	Cellulosimicrobium
Xylanimicrobium	Xylanimicrobium
Isoptericola	Isoptericola
Xylanimonas	Xylanimonas
Brevibacterium	Brevibacterium
Luteipulveratus	Luteipulveratus
Dermacoccus	Dermacoccus
Kytococcus	Kytococcus
Tetrasphaera	Tetrasphaera
Intrasporangium	Intrasporangium
Phycicoccus	Phycicoccus
Arsenicicoccus	Arsenicicoccus
Ornithinimicrobium	Ornithinimicrobium
Janibacter	Janibacter
Serinicoccus	Serinicoccus
Psychromicrobium	Psychromicrobium
Renibacterium	Renibacterium
Auritidibacter	Auritidibacter
Nesterenkonia	Nesterenkonia
Paenarthrobacter	Paenarthrobacter
Neomicrococcus	Neomicrococcus
Sinomonas	Sinomonas
Pseudarthrobacter	Pseudarthrobacter
Zhihengliuella	Zhihengliuella
Glutamicibacter	Glutamicibacter
Rothia	Rothia
Arthrobacter	Arthrobacter
Citricoccus	Citricoccus
Kocuria	Kocuria
Micrococcus	Micrococcus
Pontimonas	Pontimonas
Diaminobutyricimonas	Diaminobutyricimonas
Mycetocola	Mycetocola
Candidatus_Aquiluna	Candidatus_Aquiluna
Lysinimonas	Lysinimonas
Microcella	Microcella
Aurantimicrobium	Aurantimicrobium
Marisediminicola	Marisediminicola
Protaetiibacter	Protaetiibacter
Chryseoglobus	Chryseoglobus
Cryobacterium	Cryobacterium
Plantibacter	Plantibacter
Salinibacterium	Salinibacterium
Microterricola	Microterricola
Frondihabitans	Frondihabitans
Gryllotalpicola	Gryllotalpicola
Clavibacter	Clavibacter
Agromyces	Agromyces
Humibacter	Humibacter
Curtobacterium	Curtobacterium
Herbiconiux	Herbiconiux
Leucobacter	Leucobacter
Rhodoluna	Rhodoluna
Rathayibacter	Rathayibacter
Agrococcus	Agrococcus
Cnuibacter	Cnuibacter
Leifsonia	Leifsonia
Microbacterium	Microbacterium
Segniliparus	Segniliparus
Tsukamurella	Tsukamurella
Tomitella	Tomitella
Dietzia	Dietzia
Lawsonella	Lawsonella
Nocardia	Nocardia
Rhodococcus	Rhodococcus
Corynebacterium	Corynebacterium
Mycolicibacter	Mycolicibacter
Mycolicibacillus	Mycolicibacillus
Hoyosella	Hoyosella
Mycobacteroides	Mycobacteroides
Mycolicibacterium	Mycolicibacterium
Mycobacterium	Mycobacterium
Gordonia	Gordonia
Kribbella	Kribbella
Pimelobacter	Pimelobacter
Micropruina	Micropruina
Actinopolymorpha	Actinopolymorpha
Friedmanniella	Friedmanniella
Mumia	Mumia
Marmoricola	Marmoricola
Aeromicrobium	Aeromicrobium
Nocardioides	Nocardioides
Propionimicrobium	Propionimicrobium
Microlunatus	Microlunatus
Acidipropionibacterium	Acidipropionibacterium
Propioniciclava	Propioniciclava
Tessaracoccus	Tessaracoccus
Propionibacterium	Propionibacterium
Pseudopropionibacterium	Pseudopropionibacterium
Auraticoccus	Auraticoccus
Raineyella	Raineyella
Cutibacterium	Cutibacterium
Silvanigrella	Silvanigrella
Bacteriovorax	Bacteriovorax
Halobacteriovorax	Halobacteriovorax
Bdellovibrio	Bdellovibrio
Hydrogenophilus	Hydrogenophilus
Mariprofundus	Mariprofundus
Acidithiobacillus	Acidithiobacillus
Nitratiruptor	Nitratiruptor
Caminibacter	Caminibacter
Nautilia	Nautilia
Cetia	Cetia
Sulfurovum	Sulfurovum
Sulfuricurvum	Sulfuricurvum
Wolinella	Wolinella
Sulfurimonas	Sulfurimonas
Helicobacter	Helicobacter
Nitratifractor	Nitratifractor
Aliiarcobacter	Aliiarcobacter
Pseudoarcobacter	Pseudoarcobacter
Halarcobacter	Halarcobacter
Arcobacter	Arcobacter
Sulfurospirillum	Sulfurospirillum
Campylobacter	Campylobacter
Candidatus_Desulfofervidus	Candidatus_Desulfofervidus
Desulfurella	Desulfurella
Hippea	Hippea
Desulfotalea	Desulfotalea
Desulfocapsa	Desulfocapsa
Desulfopila	Desulfopila
Desulfurivibrio	Desulfurivibrio
Desulfobulbus	Desulfobulbus
Desulfobacula	Desulfobacula
Desulfatibacillum	Desulfatibacillum
Desulfobacterium	Desulfobacterium
Desulfosarcina	Desulfosarcina
Desulfococcus	Desulfococcus
Desulfobacter	Desulfobacter
Bradymonas	Bradymonas
Desulfarculus	Desulfarculus
Desulfobacca	Desulfobacca
Desulfomonile	Desulfomonile
Syntrophus	Syntrophus
Desulfoglaeba	Desulfoglaeba
Syntrophobacter	Syntrophobacter
Desulfohalobium	Desulfohalobium
Desulfomicrobium	Desulfomicrobium
Lawsonia	Lawsonia
Desulfocurvibacter	Desulfocurvibacter
Pseudodesulfovibrio	Pseudodesulfovibrio
Desulfovibrio	Desulfovibrio
Pelobacter	Pelobacter
Desulfuromonas	Desulfuromonas
Geoalkalibacter	Geoalkalibacter
Geobacter	Geobacter
Vulgatibacter	Vulgatibacter
Haliangium	Haliangium
Minicystis	Minicystis
Labilithrix	Labilithrix
Melittangium	Melittangium
Stigmatella	Stigmatella
Cystobacter	Cystobacter
Archangium	Archangium
Sandaracinus	Sandaracinus
Anaeromyxobacter	Anaeromyxobacter
Pajaroellobacter	Pajaroellobacter
Chondromyces	Chondromyces
Sorangium	Sorangium
Myxococcus	Myxococcus
Corallococcus	Corallococcus
Candidatus_Vesicomyosocius	Candidatus_Vesicomyosocius
Gallaecimonas	Gallaecimonas
Candidatus_Thioglobus	Candidatus_Thioglobus
Candidatus_Ruthia	Candidatus_Ruthia
Candidatus_Reidiella	Candidatus_Reidiella
Candidatus_Nardonella	Candidatus_Nardonella
Orbus	Orbus
Frischella	Frischella
Gilliamella	Gilliamella
Rickettsiella	Rickettsiella
Aquicella	Aquicella
Coxiella	Coxiella
Fluoribacter	Fluoribacter
Tatlockia	Tatlockia
Legionella	Legionella
Thiolapillus	Thiolapillus
Pseudohongiella	Pseudohongiella
Sedimenticola	Sedimenticola
Immundisolibacter	Immundisolibacter
Salinisphaera	Salinisphaera
Sinimarinibacterium	Sinimarinibacterium
Solimonas	Solimonas
Steroidobacter	Steroidobacter
Endozoicomonas	Endozoicomonas
Oleiphilus	Oleiphilus
Kangiella	Kangiella
Litoricola	Litoricola
Gynuella	Gynuella
Reinekea	Reinekea
Saccharospirillum	Saccharospirillum
Bermanella	Bermanella
Neptunomonas	Neptunomonas
Oleispira	Oleispira
Marinomonas	Marinomonas
Thalassolituus	Thalassolituus
Marinobacterium	Marinobacterium
Nitrincola	Nitrincola
Bacterioplanes	Bacterioplanes
Hahella	Hahella
Ketobacter	Ketobacter
Alcanivorax	Alcanivorax
Candidatus_Evansia	Candidatus_Evansia
Candidatus_Carsonella	Candidatus_Carsonella
Zymobacter	Zymobacter
Cobetia	Cobetia
Pistricoccus	Pistricoccus
Candidatus_Portiera	Candidatus_Portiera
Halotalea	Halotalea
Chromohalobacter	Chromohalobacter
Kushneria	Kushneria
Salinicola	Salinicola
Halomonas	Halomonas
Acidiferrobacter	Acidiferrobacter
Sulfurifustis	Sulfurifustis
Sulfuricaulis	Sulfuricaulis
Thioploca	Thioploca
Beggiatoa	Beggiatoa
Hydrogenovibrio	Hydrogenovibrio
Methylophaga	Methylophaga
Cycloclasticus	Cycloclasticus
Piscirickettsia	Piscirickettsia
Thiomicrospira	Thiomicrospira
Thiomicrorhabdus	Thiomicrorhabdus
Allofrancisella	Allofrancisella
Francisella	Francisella
Oceanicoccus	Oceanicoccus
Zhongshania	Zhongshania
Spongiibacter	Spongiibacter
Congregibacter	Congregibacter
Kineobactrum	Kineobactrum
Halioglobus	Halioglobus
Saccharophagus	Saccharophagus
Agarilytica	Agarilytica
Teredinibacter	Teredinibacter
Cellvibrio	Cellvibrio
Simiduia	Simiduia
Microbulbifer	Microbulbifer
Candidatus_Methylospira	Candidatus_Methylospira
Methylovulum	Methylovulum
Methylocaldum	Methylocaldum
Methylomicrobium	Methylomicrobium
Methylococcus	Methylococcus
Methylomonas	Methylomonas
Dichelobacter	Dichelobacter
Cardiobacterium	Cardiobacterium
Succinivibrio	Succinivibrio
Oceanimonas	Oceanimonas
Oceanisphaera	Oceanisphaera
Zobellella	Zobellella
Tolumonas	Tolumonas
Aeromonas	Aeromonas
Enterovibrio	Enterovibrio
Salinivibrio	Salinivibrio
Grimontia	Grimontia
Paraphotobacterium	Paraphotobacterium
Aliivibrio	Aliivibrio
Photobacterium	Photobacterium
Vibrio	Vibrio
Woeseia	Woeseia
Granulosicoccus	Granulosicoccus
Sulfuriflexus	Sulfuriflexus
Sulfurivermis	Sulfurivermis
Thiohalobacter	Thiohalobacter
Wenzhouxiangella	Wenzhouxiangella
Guyparkeria	Guyparkeria
Halothiobacillus	Halothiobacillus
Alkalilimnicola	Alkalilimnicola
Spiribacter	Spiribacter
Halorhodospira	Halorhodospira
Thioalkalivibrio	Thioalkalivibrio
Ectothiorhodospira	Ectothiorhodospira
Acidihalobacter	Acidihalobacter
Candidatus_Nitrosoglobus	Candidatus_Nitrosoglobus
Thiocystis	Thiocystis
Thermochromatium	Thermochromatium
Thioflavicoccus	Thioflavicoccus
Marichromatium	Marichromatium
Allochromatium	Allochromatium
Nitrosococcus	Nitrosococcus
Thiodictyon	Thiodictyon
Rheinheimera	Rheinheimera
Psychromonas	Psychromonas
Moritella	Moritella
Idiomarina	Idiomarina
Pseudoalteromonas	Pseudoalteromonas
Ferrimonas	Ferrimonas
Colwellia	Colwellia
Thalassotalea	Thalassotalea
Litorilituus	Litorilituus
Agarivorans	Agarivorans
Paraglaciecola	Paraglaciecola
Glaciecola	Glaciecola
Salinimonas	Salinimonas
Saliniradius	Saliniradius
Catenovulum	Catenovulum
Lacimicrobium	Lacimicrobium
Hydrocarboniclastica	Hydrocarboniclastica
Marinobacter	Marinobacter
Alteromonas	Alteromonas
Parashewanella	Parashewanella
Shewanella	Shewanella
Frederiksenia	Frederiksenia
Vespertiliibacter	Vespertiliibacter
Gallibacterium	Gallibacterium
Bibersteinia	Bibersteinia
Otariodibacter	Otariodibacter
Histophilus	Histophilus
Bisgaardia	Bisgaardia
Rodentibacter	Rodentibacter
Basfia	Basfia
Avibacterium	Avibacterium
Mannheimia	Mannheimia
Actinobacillus	Actinobacillus
Glaesserella	Glaesserella
Pasteurella	Pasteurella
Aggregatibacter	Aggregatibacter
Haemophilus	Haemophilus
Ahniella	Ahniella
Frateuria	Frateuria
Luteibacter	Luteibacter
Rhodanobacter	Rhodanobacter
Aerosticca	Aerosticca
Dokdonella	Dokdonella
Dyella	Dyella
Pseudolysobacter	Pseudolysobacter
Arenimonas	Arenimonas
Thermomonas	Thermomonas
Xylella	Xylella
Pseudoxanthomonas	Pseudoxanthomonas
Luteimonas	Luteimonas
Lysobacter	Lysobacter
Stenotrophomonas	Stenotrophomonas
Xanthomonas	Xanthomonas
Leminorella	Leminorella
Pragia	Pragia
Obesumbacterium	Obesumbacterium
Hafnia	Hafnia
Edwardsiella	Edwardsiella
Phytobacter	Phytobacter
Plesiomonas	Plesiomonas
Arsenophonus	Arsenophonus
Xenorhabdus	Xenorhabdus
Photorhabdus	Photorhabdus
Morganella	Morganella
Proteus	Proteus
Providencia	Providencia
Wigglesworthia	Wigglesworthia
Tatumella	Tatumella
Buchnera	Buchnera
Mixta	Mixta
Erwinia	Erwinia
Pantoea	Pantoea
Lonsdalea	Lonsdalea
Sodalis	Sodalis
Brenneria	Brenneria
Dickeya	Dickeya
Pectobacterium	Pectobacterium
Candidatus_Fukatsuia	Candidatus_Fukatsuia
Nissabacter	Nissabacter
Rouxiella	Rouxiella
Chania	Chania
Rahnella	Rahnella
Yersinia	Yersinia
Serratia	Serratia
Candidatus_Hoaglandella	Candidatus_Hoaglandella
Candidatus_Annandia	Candidatus_Annandia
Candidatus_Doolittlea	Candidatus_Doolittlea
Candidatus_Ishikawaella	Candidatus_Ishikawaella
Candidatus_Tachikawaea	Candidatus_Tachikawaea
Limnobaculum	Limnobaculum
Candidatus_Riesia	Candidatus_Riesia
Candidatus_Mikella	Candidatus_Mikella
Candidatus_Blochmannia	Candidatus_Blochmannia
Candidatus_Purcelliella	Candidatus_Purcelliella
Candidatus_Moranella	Candidatus_Moranella
Candidatus_Gullanella	Candidatus_Gullanella
Candidatus_Hamiltonella	Candidatus_Hamiltonella
Gibbsiella	Gibbsiella
Pseudescherichia	Pseudescherichia
Yokenella	Yokenella
Scandinavium	Scandinavium
Cedecea	Cedecea
Izhakiella	Izhakiella
Cronobacter	Cronobacter
Metakosakonia	Metakosakonia
Buttiauxella	Buttiauxella
Shimwellia	Shimwellia
Pluralibacter	Pluralibacter
Kosakonia	Kosakonia
Leclercia	Leclercia
Raoultella	Raoultella
Lelliottia	Lelliottia
Kluyvera	Kluyvera
Shigella	Shigella
Enterobacter	Enterobacter
Salmonella	Salmonella
Atlantibacter	Atlantibacter
Citrobacter	Citrobacter
Escherichia	Escherichia
Klebsiella	Klebsiella
Psychrobacter	Psychrobacter
Moraxella	Moraxella
Acinetobacter	Acinetobacter
Permianibacter	Permianibacter
Oblitimonas	Oblitimonas
Entomomonas	Entomomonas
Azotobacter	Azotobacter
Pseudomonas	Pseudomonas
Candidatus_Paracaedibacter	Candidatus_Paracaedibacter
Candidatus_Nucleicultrix	Candidatus_Nucleicultrix
Candidatus_Nesciobacter	Candidatus_Nesciobacter
Candidatus_Cytomitobacter	Candidatus_Cytomitobacter
Candidatus_Puniceispirillum	Candidatus_Puniceispirillum
Candidatus_Fonsibacter	Candidatus_Fonsibacter
Candidatus_Pelagibacter	Candidatus_Pelagibacter
Candidatus_Deianiraea	Candidatus_Deianiraea
Candidatus_Midichloria	Candidatus_Midichloria
Candidatus_Fokinia	Candidatus_Fokinia
Anaplasma	Anaplasma
Neorickettsia	Neorickettsia
Ehrlichia	Ehrlichia
Wolbachia	Wolbachia
Orientia	Orientia
Candidatus_Sneabacter	Candidatus_Sneabacter
Candidatus_Phycorickettsia	Candidatus_Phycorickettsia
Rickettsia	Rickettsia
Magnetococcus	Magnetococcus
Parvularcula	Parvularcula
Micavibrio	Micavibrio
Emcibacter	Emcibacter
Polymorphum	Polymorphum
Hirschia	Hirschia
Maricaulis	Maricaulis
Hyphomonas	Hyphomonas
Glycocaulis	Glycocaulis
Planktomarina	Planktomarina
Epibacterium	Epibacterium
Marivivens	Marivivens
Halocynthiibacter	Halocynthiibacter
Pseudovibrio	Pseudovibrio
Boseongicola	Boseongicola
Dinoroseobacter	Dinoroseobacter
Jannaschia	Jannaschia
Parasedimentitalea	Parasedimentitalea
Haematobacter	Haematobacter
Gemmobacter	Gemmobacter
Maribius	Maribius
Tateyamaria	Tateyamaria
Pseudorhodobacter	Pseudorhodobacter
Defluviimonas	Defluviimonas
Oceanicola	Oceanicola
Thioclava	Thioclava
Confluentimicrobium	Confluentimicrobium
Monaibacterium	Monaibacterium
Pseudohalocynthiibacter	Pseudohalocynthiibacter
Sagittula	Sagittula
Octadecabacter	Octadecabacter
Rhodobaca	Rhodobaca
Brevirhabdus	Brevirhabdus
Yoonia	Yoonia
Thalassobius	Thalassobius
Mameliella	Mameliella
Roseobacter	Roseobacter
Salipiger	Salipiger
Roseivivax	Roseivivax
Marinovum	Marinovum
Roseovarius	Roseovarius
Antarctobacter	Antarctobacter
Ketogulonicigenium	Ketogulonicigenium
Paraoceanicella	Paraoceanicella
Yangia	Yangia
Celeribacter	Celeribacter
Rhodovulum	Rhodovulum
Pelagibaca	Pelagibaca
Pannonibacter	Pannonibacter
Leisingera	Leisingera
Rhodobacter	Rhodobacter
Silicimonas	Silicimonas
Ruegeria	Ruegeria
Thalassococcus	Thalassococcus
Labrenzia	Labrenzia
Tabrizicola	Tabrizicola
Phaeobacter	Phaeobacter
Roseibacterium	Roseibacterium
Stappia	Stappia
Sulfitobacter	Sulfitobacter
Litoreibacter	Litoreibacter
Paracoccus	Paracoccus
Bombella	Bombella
Commensalibacter	Commensalibacter
Neokomagataea	Neokomagataea
Asaia	Asaia
Parasaccharibacter	Parasaccharibacter
Neoasaia	Neoasaia
Gluconobacter	Gluconobacter
Acidibrevibacterium	Acidibrevibacterium
Swingsia	Swingsia
Kozakia	Kozakia
Stella	Stella
Acidiphilium	Acidiphilium
Komagataeibacter	Komagataeibacter
Granulibacter	Granulibacter
Gluconacetobacter	Gluconacetobacter
Roseomonas	Roseomonas
Acetobacter	Acetobacter
Candidatus_Endolissoclinum	Candidatus_Endolissoclinum
Haematospirillum	Haematospirillum
Magnetospira	Magnetospira
Pararhodospirillum	Pararhodospirillum
Indioceanicola	Indioceanicola
Rhodospirillum	Rhodospirillum
Skermanella	Skermanella
Tistrella	Tistrella
Niveispirillum	Niveispirillum
Thalassospira	Thalassospira
Hypericibacter	Hypericibacter
Magnetospirillum	Magnetospirillum
Ferrovibrio	Ferrovibrio
Azospirillum	Azospirillum
Nitrospirillum	Nitrospirillum
Phreatobacter	Phreatobacter
Phenylobacterium	Phenylobacterium
Asticcacaulis	Asticcacaulis
Caulobacter	Caulobacter
Brevundimonas	Brevundimonas
Croceicoccus	Croceicoccus
Altererythrobacter	Altererythrobacter
Qipengyuania	Qipengyuania
Porphyrobacter	Porphyrobacter
Erythrobacter	Erythrobacter
Zymomonas	Zymomonas
Sandaracinobacter	Sandaracinobacter
Parasphingopyxis	Parasphingopyxis
Sphingorhabdus	Sphingorhabdus
Rhizorhabdus	Rhizorhabdus
Tardibacter	Tardibacter
Sphingosinicella	Sphingosinicella
Citromicrobium	Citromicrobium
Blastomonas	Blastomonas
Sphingopyxis	Sphingopyxis
Sphingosinithalassobacter	Sphingosinithalassobacter
Novosphingobium	Novosphingobium
Sphingobium	Sphingobium
Sphingomonas	Sphingomonas
Candidatus_Hodgkinia	Candidatus_Hodgkinia
Bartonella	Bartonella
Lichenihabitans	Lichenihabitans
Cohaesibacter	Cohaesibacter
Breoghania	Breoghania
Chelatococcus	Chelatococcus
Methyloligella	Methyloligella
Hartmannibacter	Hartmannibacter
Pseudorhodoplanes	Pseudorhodoplanes
Candidatus_Phaeomarinobacter	Candidatus_Phaeomarinobacter
Parvibaculum	Parvibaculum
Pyruvatibacter	Pyruvatibacter
Methylovirgula	Methylovirgula
Methylocella	Methylocella
Beijerinckia	Beijerinckia
Methyloceanibacter	Methyloceanibacter
Nordella	Nordella
Martelella	Martelella
Aureimonas	Aureimonas
Terasakiella	Terasakiella
Methylosinus	Methylosinus
Methylocystis	Methylocystis
Labrys	Labrys
Azorhizobium	Azorhizobium
Starkeya	Starkeya
Pseudolabrys	Pseudolabrys
Xanthobacter	Xanthobacter
Ancylobacter	Ancylobacter
Brucella	Brucella
Ochrobactrum	Ochrobactrum
Maritalea	Maritalea
Youhaiella	Youhaiella
Pelagibacterium	Pelagibacterium
Rhodomicrobium	Rhodomicrobium
Blastochloris	Blastochloris
Filomicrobium	Filomicrobium
Devosia	Devosia
Hyphomicrobium	Hyphomicrobium
Rhodoplanes	Rhodoplanes
Lentilitoribacter	Lentilitoribacter
Oricola	Oricola
Hoeflea	Hoeflea
Salaquimonas	Salaquimonas
Phyllobacterium	Phyllobacterium
Roseitalea	Roseitalea
Chelativorans	Chelativorans
Nitratireductor	Nitratireductor
Aminobacter	Aminobacter
Mesorhizobium	Mesorhizobium
Microvirga	Microvirga
Methylorubrum	Methylorubrum
Methylobacterium	Methylobacterium
Liberibacter	Liberibacter
Ciceribacter	Ciceribacter
Neorhizobium	Neorhizobium
Sinorhizobium	Sinorhizobium
Ensifer	Ensifer
Shinella	Shinella
Georhizobium	Georhizobium
Agrobacterium	Agrobacterium
Rhizobium	Rhizobium
Tardiphaga	Tardiphaga
Variibacter	Variibacter
Oligotropha	Oligotropha
Nitrobacter	Nitrobacter
Bosea	Bosea
Afipia	Afipia
Rhodopseudomonas	Rhodopseudomonas
Bradyrhizobium	Bradyrhizobium
Candidatus_Tremblaya	Candidatus_Tremblaya
Candidatus_Nasuia	Candidatus_Nasuia
Candidatus_Profftella	Candidatus_Profftella
Candidatus_Kinetoplastibacterium	Candidatus_Kinetoplastibacterium
Candidatus_Accumulibacter	Candidatus_Accumulibacter
Casimicrobium	Casimicrobium
Sulfuritortus	Sulfuritortus
Thiobacillus	Thiobacillus
Candidatus_Nitrotoga	Candidatus_Nitrotoga
Gallionella	Gallionella
Ferriphaselus	Ferriphaselus
Sideroxydans	Sideroxydans
Sulfuriferula	Sulfuriferula
Sulfuricella	Sulfuricella
Nitrosomonas	Nitrosomonas
Nitrosospira	Nitrosospira
Methylobacillus	Methylobacillus
Methylovorus	Methylovorus
Methylotenera	Methylotenera
Methylophilus	Methylophilus
Candidatus_Methylopumilus	Candidatus_Methylopumilus
Sterolibacterium	Sterolibacterium
Sulfuritalea	Sulfuritalea
Denitratisoma	Denitratisoma
Methyloversatilis	Methyloversatilis
Dechloromonas	Dechloromonas
Aromatoleum	Aromatoleum
Oryzomicrobium	Oryzomicrobium
Azospira	Azospira
Azoarcus	Azoarcus
Thauera	Thauera
Deefgea	Deefgea
Iodobacter	Iodobacter
Aquaspirillum	Aquaspirillum
Jeongeupia	Jeongeupia
Chitinibacter	Chitinibacter
Chromobacterium	Chromobacterium
Vogesella	Vogesella
Microvirgula	Microvirgula
Pseudogulbenkiania	Pseudogulbenkiania
Laribacter	Laribacter
Aquitalea	Aquitalea
Alysiella	Alysiella
Simonsiella	Simonsiella
Conchiformibius	Conchiformibius
Snodgrassella	Snodgrassella
Chitinolyticbacter	Chitinolyticbacter
Crenobacter	Crenobacter
Eikenella	Eikenella
Neisseria	Neisseria
Vitreoscilla	Vitreoscilla
Kingella	Kingella
Sutterella	Sutterella
Oxalobacter	Oxalobacter
Herminiimonas	Herminiimonas
Noviherbaspirillum	Noviherbaspirillum
Duganella	Duganella
Collimonas	Collimonas
Herbaspirillum	Herbaspirillum
Undibacterium	Undibacterium
Janthinobacterium	Janthinobacterium
Massilia	Massilia
Basilea	Basilea
Paenalcaligenes	Paenalcaligenes
Oligella	Oligella
Advenella	Advenella
Taylorella	Taylorella
Castellaniella	Castellaniella
Orrella	Orrella
Pusillimonas	Pusillimonas
Kerstersia	Kerstersia
Pelistega	Pelistega
Pigmentiphaga	Pigmentiphaga
Achromobacter	Achromobacter
Bordetella	Bordetella
Alcaligenes	Alcaligenes
Mycoavidus	Mycoavidus
Ephemeroptericola	Ephemeroptericola
Limnobacter	Limnobacter
Mycetohabitans	Mycetohabitans
Chitinimonas	Chitinimonas
Lautropia	Lautropia
Polynucleobacter	Polynucleobacter
Caballeronia	Caballeronia
Pandoraea	Pandoraea
Paraburkholderia	Paraburkholderia
Burkholderia	Burkholderia
Cupriavidus	Cupriavidus
Ralstonia	Ralstonia
Thiomonas	Thiomonas
Rhizobacter	Rhizobacter
Leptothrix	Leptothrix
Sphaerotilus	Sphaerotilus
Xylophilus	Xylophilus
Aquabacterium	Aquabacterium
Roseateles	Roseateles
Inhella	Inhella
Rubrivivax	Rubrivivax
Methylibium	Methylibium
Mitsuaria	Mitsuaria
Paucibacter	Paucibacter
Candidatus_Symbiobacter	Candidatus_Symbiobacter
Pulveribacter	Pulveribacter
Serpentinomonas	Serpentinomonas
Curvibacter	Curvibacter
Verminephrobacter	Verminephrobacter
Ottowia	Ottowia
Limnohabitans	Limnohabitans
Simplicispira	Simplicispira
Diaphorobacter	Diaphorobacter
Melaminivora	Melaminivora
Hylemonella	Hylemonella
Rhodoferax	Rhodoferax
Alicycliphilus	Alicycliphilus
Ramlibacter	Ramlibacter
Delftia	Delftia
Polaromonas	Polaromonas
Comamonas	Comamonas
Hydrogenophaga	Hydrogenophaga
Acidovorax	Acidovorax
Variovorax	Variovorax
Candidatus_Korarchaeum	Candidatus_Korarchaeum
Conexivisphaera	Conexivisphaera
Candidatus_Mancarchaeum	Candidatus_Mancarchaeum
Candidatus_Prometheoarchaeum	Candidatus_Prometheoarchaeum
Fervidicoccus	Fervidicoccus
Caldisphaera	Caldisphaera
Acidilobus	Acidilobus
Thermofilum	Thermofilum
Caldivirga	Caldivirga
Thermoproteus	Thermoproteus
Vulcanisaeta	Vulcanisaeta
Pyrobaculum	Pyrobaculum
Stygiolobus	Stygiolobus
Saccharolobus	Saccharolobus
Sulfodiicoccus	Sulfodiicoccus
Sulfurisphaera	Sulfurisphaera
Sulfuracidifex	Sulfuracidifex
Sulfolobus	Sulfolobus
Metallosphaera	Metallosphaera
Acidianus	Acidianus
Hyperthermus	Hyperthermus
Pyrolobus	Pyrolobus
Pyrodictium	Pyrodictium
Ignicoccus	Ignicoccus
Desulfurococcus	Desulfurococcus
Aeropyrum	Aeropyrum
Staphylothermus	Staphylothermus
Thermosphaera	Thermosphaera
Thermogladius	Thermogladius
Candidatus_Nitrosopelagicus	Candidatus_Nitrosopelagicus
Candidatus_Nitrosotalea	Candidatus_Nitrosotalea
Candidatus_Nitrosotenuis	Candidatus_Nitrosotenuis
Candidatus_Nitrosocaldus	Candidatus_Nitrosocaldus
Candidatus_Nitrosocosmicus	Candidatus_Nitrosocosmicus
Nitrososphaera	Nitrososphaera
Candidatus_Nitrosomarinus	Candidatus_Nitrosomarinus
Nitrosopumilus	Nitrosopumilus
Nitrosarchaeum	Nitrosarchaeum
Methanopyrus	Methanopyrus
Aciduliprofundum	Aciduliprofundum
Geoglobus	Geoglobus
Ferroglobus	Ferroglobus
Archaeoglobus	Archaeoglobus
Methanothermococcus	Methanothermococcus
Methanococcus	Methanococcus
Methanofervidicoccus	Methanofervidicoccus
Methanotorris	Methanotorris
Methanocaldococcus	Methanocaldococcus
Palaeococcus	Palaeococcus
Thermococcus	Thermococcus
Pyrococcus	Pyrococcus
Thermoplasma	Thermoplasma
Picrophilus	Picrophilus
Ferroplasma	Ferroplasma
Cuniculiplasma	Cuniculiplasma
Candidatus_Methanomethylophilus	Candidatus_Methanomethylophilus
Candidatus_Methanoplasma	Candidatus_Methanoplasma
Methanomassiliicoccus	Methanomassiliicoccus
Methanothermus	Methanothermus
Methanothermobacter	Methanothermobacter
Methanosphaera	Methanosphaera
Methanobacterium	Methanobacterium
Methanobrevibacter	Methanobrevibacter
Methanocella	Methanocella
Methanospirillum	Methanospirillum
Methanocorpusculum	Methanocorpusculum
Methanoregula	Methanoregula
Methanosphaerula	Methanosphaerula
Methanolacinia	Methanolacinia
Methanoplanus	Methanoplanus
Methanofollis	Methanofollis
Methanoculleus	Methanoculleus
Methanothrix	Methanothrix
Methanosalsum	Methanosalsum
Methanohalobium	Methanohalobium
Methanolobus	Methanolobus
Methanohalophilus	Methanohalophilus
Methanococcoides	Methanococcoides
Methanomethylovorans	Methanomethylovorans
Methanosarcina	Methanosarcina
Halalkaliarchaeum	Halalkaliarchaeum
Haloquadratum	Haloquadratum
Halogeometricum	Halogeometricum
Haloprofundus	Haloprofundus
Haloferax	Haloferax
Halobellus	Halobellus
Haloplanus	Haloplanus
Salinigranum	Salinigranum
Halopenitus	Halopenitus
Halolamina	Halolamina
Candidatus_Halobonum	Candidatus_Halobonum
Halorubrum	Halorubrum
Halostagnicola	Halostagnicola
Halobiforma	Halobiforma
Natrialba	Natrialba
Natronococcus	Natronococcus
Halovivax	Halovivax
Salinarchaeum	Salinarchaeum
Haloterrigena	Haloterrigena
Natronorubrum	Natronorubrum
Natronolimnobius	Natronolimnobius
Natronobacterium	Natronobacterium
Natrinema	Natrinema
Halopiger	Halopiger
Salinibaculum	Salinibaculum
Halodesulfurarchaeum	Halodesulfurarchaeum
Halostella	Halostella
Halarchaeum	Halarchaeum
Halanaeroarchaeum	Halanaeroarchaeum
Salarchaeum	Salarchaeum
Halorussus	Halorussus
Halalkalicoccus	Halalkalicoccus
Halobacterium	Halobacterium
Halapricum	Halapricum
Halorientalis	Halorientalis
Natronomonas	Natronomonas
Haloarcula	Haloarcula
Halomicrobium	Halomicrobium
Halosimplex	Halosimplex
Halorhabdus	Halorhabdus
Glossinavirus	Glossinavirus
Whispovirus	Whispovirus
Rudivirus	Rudivirus
Betalipothrixvirus	Betalipothrixvirus
Alphasphaerolipovirus	Alphasphaerolipovirus
Betanudivirus	Betanudivirus
Bracovirus	Bracovirus
Pandoravirus	Pandoravirus
Alphatrevirus	Alphatrevirus
Gequatrovirus	Gequatrovirus
Badnavirus	Badnavirus
Cavemovirus	Cavemovirus
Solendovirus	Solendovirus
Caulimovirus	Caulimovirus
Deltaretrovirus	Deltaretrovirus
Simiispumavirus	Simiispumavirus
Alpharetrovirus	Alpharetrovirus
Betaretrovirus	Betaretrovirus
Lentivirus	Lentivirus
Gammaretrovirus	Gammaretrovirus
Orthohepadnavirus	Orthohepadnavirus
Infulavirus	Infulavirus
Staminivirus	Staminivirus
Subteminivirus	Subteminivirus
Psecadovirus	Psecadovirus
Scuticavirus	Scuticavirus
Inovirus	Inovirus
Cyclovirus	Cyclovirus
Circovirus	Circovirus
Mastrevirus	Mastrevirus
Begomovirus	Begomovirus
Gemykrogvirus	Gemykrogvirus
Gemykroznavirus	Gemykroznavirus
Gemykibivirus	Gemykibivirus
Dyothetapapillomavirus	Dyothetapapillomavirus
Nupapillomavirus	Nupapillomavirus
Dyokappapapillomavirus	Dyokappapapillomavirus
Dyopipapillomavirus	Dyopipapillomavirus
Mupapillomavirus	Mupapillomavirus
Upsilonpapillomavirus	Upsilonpapillomavirus
Taupapillomavirus	Taupapillomavirus
Gammapapillomavirus	Gammapapillomavirus
Betapapillomavirus	Betapapillomavirus
Alphapapillomavirus	Alphapapillomavirus
Gammapolyomavirus	Gammapolyomavirus
Alphapolyomavirus	Alphapolyomavirus
Deltapolyomavirus	Deltapolyomavirus
Betapolyomavirus	Betapolyomavirus
Copiparvovirus	Copiparvovirus
Scindoambidensovirus	Scindoambidensovirus
Iteradensovirus	Iteradensovirus
Protoparvovirus	Protoparvovirus
Tetraparvovirus	Tetraparvovirus
Erythroparvovirus	Erythroparvovirus
Dependoparvovirus	Dependoparvovirus
Botybirnavirus	Botybirnavirus
Scleroulivirus	Scleroulivirus
Narnavirus	Narnavirus
Levivirus	Levivirus
Alphachrysovirus	Alphachrysovirus
Trichomonasvirus	Trichomonasvirus
Victorivirus	Victorivirus
Totivirus	Totivirus
Rymovirus	Rymovirus
Potyvirus	Potyvirus
Alphacoronavirus	Alphacoronavirus
Betacoronavirus	Betacoronavirus
Nyfulvavirus	Nyfulvavirus
Nepovirus	Nepovirus
Iflavirus	Iflavirus
Norovirus	Norovirus
Cripavirus	Cripavirus
Kobuvirus	Kobuvirus
Salivirus	Salivirus
Megrivirus	Megrivirus
Enterovirus	Enterovirus
Cardiovirus	Cardiovirus
Lolavirus	Lolavirus
Mandarivirus	Mandarivirus
Potexvirus	Potexvirus
Foveavirus	Foveavirus
Capillovirus	Capillovirus
Ilarvirus	Ilarvirus
Cucumovirus	Cucumovirus
Alfamovirus	Alfamovirus
Bromovirus	Bromovirus
Tobamovirus	Tobamovirus
Alphaendornavirus	Alphaendornavirus
Crinivirus	Crinivirus
Panicovirus	Panicovirus
Polerovirus	Polerovirus
Pestivirus	Pestivirus
Hepacivirus	Hepacivirus
Flavivirus	Flavivirus
Alphainfluenzavirus	Alphainfluenzavirus
Gammainfluenzavirus	Gammainfluenzavirus
Orthotospovirus	Orthotospovirus
Shangavirus	Shangavirus
Orthobunyavirus	Orthobunyavirus
Orthohantavirus	Orthohantavirus
Metapneumovirus	Metapneumovirus
Peropuvirus	Peropuvirus
Varicosavirus	Varicosavirus
Vesiculovirus	Vesiculovirus
Lyssavirus	Lyssavirus
Kuttervirus	Kuttervirus
Taipeivirus	Taipeivirus
Limestonevirus	Limestonevirus
Agtrevirus	Agtrevirus
Suwonvirus	Suwonvirus
Faunusvirus	Faunusvirus
Carltongylesvirus	Carltongylesvirus
Loessnervirus	Loessnervirus
Myunavirus	Myunavirus
Haartmanvirus	Haartmanvirus
Novosibvirus	Novosibvirus
Sugarlandvirus	Sugarlandvirus
Shenzhenvirus	Shenzhenvirus
Epseptimavirus	Epseptimavirus
Vipunavirus	Vipunavirus
Tequintavirus	Tequintavirus
Jesfedecavirus	Jesfedecavirus
Eclunavirus	Eclunavirus
Nouzillyvirus	Nouzillyvirus
Tunavirus	Tunavirus
Christensenvirus	Christensenvirus
Hanrivervirus	Hanrivervirus
Guelphvirus	Guelphvirus
Rtpvirus	Rtpvirus
Webervirus	Webervirus
Foetvirus	Foetvirus
Paadamvirus	Paadamvirus
Cheungvirus	Cheungvirus
Stompelvirus	Stompelvirus
Powvirus	Powvirus
Elunavirus	Elunavirus
Phimunavirus	Phimunavirus
Pradovirus	Pradovirus
Piedvirus	Piedvirus
Przondovirus	Przondovirus
Zindervirus	Zindervirus
Tunggulviirus	Tunggulviirus
Serkorvirus	Serkorvirus
Bonnellvirus	Bonnellvirus
Gyeongsanvirus	Gyeongsanvirus
Pelagivirus	Pelagivirus
Risjevirus	Risjevirus
Cronosvirus	Cronosvirus
Foturvirus	Foturvirus
Friunavirus	Friunavirus
Koutsourovirus	Koutsourovirus
Phutvirus	Phutvirus
Gajwadongvirus	Gajwadongvirus
Ermolevavirus	Ermolevavirus
Napahaivirus	Napahaivirus
Drulisvirus	Drulisvirus
Scottvirus	Scottvirus
Eracentumvirus	Eracentumvirus
Vectrevirus	Vectrevirus
Ningirsuvirus	Ningirsuvirus
Bifseptvirus	Bifseptvirus
Kalppathivirus	Kalppathivirus
Stubburvirus	Stubburvirus
Ghunavirus	Ghunavirus
Teetrevirus	Teetrevirus
Pairvirus	Pairvirus
Troedvirus	Troedvirus
Panjvirus	Panjvirus
Stopavirus	Stopavirus
Caroctavirus	Caroctavirus
Teseptimavirus	Teseptimavirus
Pifdecavirus	Pifdecavirus
Kayfunavirus	Kayfunavirus
Pijolavirus	Pijolavirus
Pollyceevirus	Pollyceevirus
Votkovvirus	Votkovvirus
Mguuvirus	Mguuvirus
Agatevirus	Agatevirus
Caeruleovirus	Caeruleovirus
Okubovirus	Okubovirus
Nitunavirus	Nitunavirus
Tsarbombavirus	Tsarbombavirus
Bequatrovirus	Bequatrovirus
Harbinvirus	Harbinvirus
Pecentumvirus	Pecentumvirus
Wphvirus	Wphvirus
Kochikohdavirus	Kochikohdavirus
Schiekvirus	Schiekvirus
Sciuriunavirus	Sciuriunavirus
Silviavirus	Silviavirus
Twortvirus	Twortvirus
Kayvirus	Kayvirus
Sepunavirus	Sepunavirus
Baoshanvirus	Baoshanvirus
Skarprettervirus	Skarprettervirus
Kelquatrovirus	Kelquatrovirus
Bruynoghevirus	Bruynoghevirus
Enquatrovirus	Enquatrovirus
Perisivirus	Perisivirus
Lederbergvirus	Lederbergvirus
Ithacavirus	Ithacavirus
Ryyoungvirus	Ryyoungvirus
Johnsonvirus	Johnsonvirus
Traversvirus	Traversvirus
Jwalphavirus	Jwalphavirus
Bjornvirus	Bjornvirus
Luzseptimavirus	Luzseptimavirus
Baltimorevirus	Baltimorevirus
Uetakevirus	Uetakevirus
Kochitakasuvirus	Kochitakasuvirus
Litunavirus	Litunavirus
Schmidvirus	Schmidvirus
Andhravirus	Andhravirus
Salasvirus	Salasvirus
Gamaleyavirus	Gamaleyavirus
Cepunavirus	Cepunavirus
Lessievirus	Lessievirus
Rosenblumvirus	Rosenblumvirus
Fipvunavirus	Fipvunavirus
Hollowayvirus	Hollowayvirus
Marthavirus	Marthavirus
Tamkungvirus	Tamkungvirus
Heilongjiangvirus	Heilongjiangvirus
Ripduovirus	Ripduovirus
Wellingtonvirus	Wellingtonvirus
Chiangmaivirus	Chiangmaivirus
Emdodecavirus	Emdodecavirus
Eganvirus	Eganvirus
Vhmlvirus	Vhmlvirus
Seongnamvirus	Seongnamvirus
Gaprivervirus	Gaprivervirus
Bielevirus	Bielevirus
Muvirus	Muvirus
Hapunavirus	Hapunavirus
Punavirus	Punavirus
Bellamyvirus	Bellamyvirus
Ficleduovirus	Ficleduovirus
Mooglevirus	Mooglevirus
Palaemonvirus	Palaemonvirus
Thaumasvirus	Thaumasvirus
Thornevirus	Thornevirus
Nankokuvirus	Nankokuvirus
Salacisavirus	Salacisavirus
Leucotheavirus	Leucotheavirus
Risingsunvirus	Risingsunvirus
Tabernariusvirus	Tabernariusvirus
Winklervirus	Winklervirus
Seoulvirus	Seoulvirus
Acionnavirus	Acionnavirus
Jilinvirus	Jilinvirus
Dhakavirus	Dhakavirus
Erskinevirus	Erskinevirus
Plaisancevirus	Plaisancevirus
Alexandravirus	Alexandravirus
Salmondvirus	Salmondvirus
Vellamovirus	Vellamovirus
Fletchervirus	Fletchervirus
Mosigvirus	Mosigvirus
Gelderlandvirus	Gelderlandvirus
Polybotosvirus	Polybotosvirus
Machinavirus	Machinavirus
Pakpunavirus	Pakpunavirus
Yokohamavirus	Yokohamavirus
Goslarvirus	Goslarvirus
Svunavirus	Svunavirus
Saclayvirus	Saclayvirus
Avunavirus	Avunavirus
Pontusvirus	Pontusvirus
Thetisvirus	Thetisvirus
Metrivirus	Metrivirus
Suspvirus	Suspvirus
Phapecoctavirus	Phapecoctavirus
Iapetusvirus	Iapetusvirus
Asteriusvirus	Asteriusvirus
Libanvirus	Libanvirus
Nerrivikvirus	Nerrivikvirus
Llyrvirus	Llyrvirus
Eurybiavirus	Eurybiavirus
Jedunavirus	Jedunavirus
Bixzunavirus	Bixzunavirus
Tulanevirus	Tulanevirus
Agricanvirus	Agricanvirus
Noxifervirus	Noxifervirus
Simpcentumvirus	Simpcentumvirus
Certrevirus	Certrevirus
Kolesnikvirus	Kolesnikvirus
Chakrabartyvirus	Chakrabartyvirus
Canoevirus	Canoevirus
Seunavirus	Seunavirus
Tegunavirus	Tegunavirus
Krischvirus	Krischvirus
Kisquattuordecimvirus	Kisquattuordecimvirus
Phabquatrovirus	Phabquatrovirus
Slopekvirus	Slopekvirus
Mimasvirus	Mimasvirus
Derbicusvirus	Derbicusvirus
Elvirus	Elvirus
Charybdisvirus	Charybdisvirus
Jiaodavirus	Jiaodavirus
Aokuangvirus	Aokuangvirus
Aresaunavirus	Aresaunavirus
Neptunevirus	Neptunevirus
Viunavirus	Viunavirus
Vequintavirus	Vequintavirus
Anaposvirus	Anaposvirus
Moonvirus	Moonvirus
Shalavirus	Shalavirus
Baikalvirus	Baikalvirus
Brigitvirus	Brigitvirus
Popoffvirus	Popoffvirus
Lubbockvirus	Lubbockvirus
Eponavirus	Eponavirus
Kanaloavirus	Kanaloavirus
Peduovirus	Peduovirus
Flaumdravirus	Flaumdravirus
Peatvirus	Peatvirus
Hpunavirus	Hpunavirus
Felixounavirus	Felixounavirus
Sasquatchvirus	Sasquatchvirus
Otagovirus	Otagovirus
Pbunavirus	Pbunavirus
Karamvirus	Karamvirus
Eneladusvirus	Eneladusvirus
Citexvirus	Citexvirus
Phikzvirus	Phikzvirus
Obolenskvirus	Obolenskvirus
Alcyoneusvirus	Alcyoneusvirus
Tequatrovirus	Tequatrovirus
Toutatisvirus	Toutatisvirus
Taranisvirus	Taranisvirus
Klementvirus	Klementvirus
Coopervirus	Coopervirus
Schnabeltiervirus	Schnabeltiervirus
Minunavirus	Minunavirus
Titanvirus	Titanvirus
Maenadvirus	Maenadvirus
Mementomorivirus	Mementomorivirus
Murrayvirus	Murrayvirus
Gaiavirus	Gaiavirus
Ahduovirus	Ahduovirus
Bernalvirus	Bernalvirus
Montyvirus	Montyvirus
Smoothievirus	Smoothievirus
Sasvirus	Sasvirus
Raleighvirus	Raleighvirus
Schubertvirus	Schubertvirus
Britbratvirus	Britbratvirus
Cecivirus	Cecivirus
Samunavirus	Samunavirus
Liefievirus	Liefievirus
Redivirus	Redivirus
Vojvodinavirus	Vojvodinavirus
Edenvirus	Edenvirus
Godonkavirus	Godonkavirus
Lanavirus	Lanavirus
Maxrubnervirus	Maxrubnervirus
Nymphadoravirus	Nymphadoravirus
Unahavirus	Unahavirus
Krampusvirus	Krampusvirus
Betterkatzvirus	Betterkatzvirus
Helsingorvirus	Helsingorvirus
Sourvirus	Sourvirus
Phifelvirus	Phifelvirus
Pulverervirus	Pulverervirus
Stanholtvirus	Stanholtvirus
Andrewvirus	Andrewvirus
Triavirus	Triavirus
Tortellinivirus	Tortellinivirus
Priunavirus	Priunavirus
Nonanavirus	Nonanavirus
Fibralongavirus	Fibralongavirus
Spbetavirus	Spbetavirus
Lidleunavirus	Lidleunavirus
Nipunavirus	Nipunavirus
Lacusarxvirus	Lacusarxvirus
Inhavirus	Inhavirus
Abidjanvirus	Abidjanvirus
Trinavirus	Trinavirus
Bronvirus	Bronvirus
Kelleziovirus	Kelleziovirus
Ravinvirus	Ravinvirus
Scapunavirus	Scapunavirus
Ceetrepovirus	Ceetrepovirus
Coetzeevirus	Coetzeevirus
Fishburnevirus	Fishburnevirus
Pikminvirus	Pikminvirus
Neferthenavirus	Neferthenavirus
Chenonavirus	Chenonavirus
Sashavirus	Sashavirus
Elerivirus	Elerivirus
Cequinquevirus	Cequinquevirus
Gordonvirus	Gordonvirus
Samistivirus	Samistivirus
Saundersvirus	Saundersvirus
Kojivirus	Kojivirus
Rowavirus	Rowavirus
Squashvirus	Squashvirus
Biseptimavirus	Biseptimavirus
Hendrixvirus	Hendrixvirus
Juiceboxvirus	Juiceboxvirus
Incheonvrus	Incheonvrus
Douglaswolinvirus	Douglaswolinvirus
Poindextervirus	Poindextervirus
Nonagvirus	Nonagvirus
Zetavirus	Zetavirus
Steinhofvirus	Steinhofvirus
Doucettevirus	Doucettevirus
Rogerhendrixvirus	Rogerhendrixvirus
Timquatrovirus	Timquatrovirus
Terapinvirus	Terapinvirus
Kostyavirus	Kostyavirus
Korravirus	Korravirus
Luckytenvirus	Luckytenvirus
Likavirus	Likavirus
Mudcatvirus	Mudcatvirus
Bingvirus	Bingvirus
Pepyhexavirus	Pepyhexavirus
Rimavirus	Rimavirus
Vieuvirus	Vieuvirus
Feofaniavirus	Feofaniavirus
Limdunavirus	Limdunavirus
Nickievirus	Nickievirus
Detrevirus	Detrevirus
Getalongvirus	Getalongvirus
Kilunavirus	Kilunavirus
Unaquatrovirus	Unaquatrovirus
Delepquintavirus	Delepquintavirus
Quhwahvirus	Quhwahvirus
Samwavirus	Samwavirus
Pamexvirus	Pamexvirus
Galunavirus	Galunavirus
Fromanvirus	Fromanvirus
Pegunavirus	Pegunavirus
Colossusvirus	Colossusvirus
Yuavirus	Yuavirus
Phicbkvirus	Phicbkvirus
Jerseyvirus	Jerseyvirus
Kagunavirus	Kagunavirus
Ilzatvirus	Ilzatvirus
Chivirus	Chivirus
Efquatrovirus	Efquatrovirus
Sanovirus	Sanovirus
Bertelyvirus	Bertelyvirus
Cornellvirus	Cornellvirus
Roufvirus	Roufvirus
Brussowvirus	Brussowvirus
Lughvirus	Lughvirus
Oengusvirus	Oengusvirus
Chunghsingvirus	Chunghsingvirus
Marvinvirus	Marvinvirus
Wizardvirus	Wizardvirus
Cheoctovirus	Cheoctovirus
Casadabanvirus	Casadabanvirus
Hiyaavirus	Hiyaavirus
Ceduovirus	Ceduovirus
Septimatrevirus	Septimatrevirus
Dhillonvirus	Dhillonvirus
Phietavirus	Phietavirus
Sextaecvirus	Sextaecvirus
Skunavirus	Skunavirus
Gorganvirus	Gorganvirus
Baxtervirus	Baxtervirus
Moineauvirus	Moineauvirus
Oneupvirus	Oneupvirus
Pahexavirus	Pahexavirus
Gammatorquevirus	Gammatorquevirus
Betatorquevirus	Betatorquevirus
Alphatorquevirus	Alphatorquevirus
Gammabaculovirus	Gammabaculovirus
Betabaculovirus	Betabaculovirus
Alphabaculovirus	Alphabaculovirus
Toursvirus	Toursvirus
Ascovirus	Ascovirus
Chloriridovirus	Chloriridovirus
Ranavirus	Ranavirus
Iridovirus	Iridovirus
Marseillevirus	Marseillevirus
Cafeteriavirus	Cafeteriavirus
Mimivirus	Mimivirus
Prymnesiovirus	Prymnesiovirus
Coccolithovirus	Coccolithovirus
Chlorovirus	Chlorovirus
Raphidovirus	Raphidovirus
Prasinovirus	Prasinovirus
Alphaentomopoxvirus	Alphaentomopoxvirus
Avipoxvirus	Avipoxvirus
Vespertilionpoxvirus	Vespertilionpoxvirus
Centapoxvirus	Centapoxvirus
Molluscipoxvirus	Molluscipoxvirus
Parapoxvirus	Parapoxvirus
Betaentomopoxvirus	Betaentomopoxvirus
Orthopoxvirus	Orthopoxvirus
Betatectivirus	Betatectivirus
Aviadenovirus	Aviadenovirus
Mastadenovirus	Mastadenovirus
Batrachovirus	Batrachovirus
Cyprinivirus	Cyprinivirus
Proboscivirus	Proboscivirus
Varicellovirus	Varicellovirus
Rhadinovirus	Rhadinovirus
Percavirus	Percavirus
Mardivirus	Mardivirus
Simplexvirus	Simplexvirus
Muromegalovirus	Muromegalovirus
Cytomegalovirus	Cytomegalovirus
Lymphocryptovirus	Lymphocryptovirus
Roseolovirus	Roseolovirus
